11111111111111111111
100000C00000000000C1
10000111110000000001
10000000000000000001
10000000000000000001
10000000000000000001
10000000000000000001
10000000000000000001
1P0011E00C0000000001
11111111111111111111