11111111111
1CEP0000001
11111111111