1111111111111
 1001000000C1
100001111101 
1P0011E000001
1111111111111