1111111111111
1001000000C1
10011111001
1P11E00001
111111111