1111111111
10000000P1
1000000E01
1111111111