1111111111
10000000P1
1000000C01
1111111111