1111111111
10000000C1
1000000E01
1111111111