1111111111111
100100C0000C1
1110011111001
1P1011E00C001
1111111111111