1111101111
100C0000P1
1000000E01
1111111111