1111111111
1000X000P1
10E0000C01
1111111111